15 20
1 1 1 1 1 1 1 1 1 1 1 1 1 1 1 1 1 1 1 1 
1 3 3 3 3 3 3 3 3 3 3 3 3 3 3 3 3 3 3 1 
1 3 0 0 0 0 0 0 0 0 0 0 0 0 0 0 0 0 3 1 
1 3 0 0 0 0 0 0 0 0 0 0 0 0 0 0 0 0 3 1 
1 3 0 0 0 0 0 0 0 0 0 0 0 0 0 0 0 0 3 1 
1 3 0 0 0 3 3 3 3 3 3 3 3 3 3 0 0 0 3 1 
1 3 0 0 0 3 1 1 1 1 1 1 1 1 3 0 0 0 3 1 
1 3 0 2 0 3 1 1 1 1 1 1 1 1 3 0 0 0 3 1 
1 3 0 2 0 3 1 1 1 1 1 1 1 1 3 0 0 0 3 1 
1 3 0 0 0 3 3 3 3 3 3 3 3 3 3 0 0 0 3 1 
1 3 0 0 0 0 0 0 0 0 0 0 0 0 0 0 0 0 3 1 
1 3 0 0 0 0 0 0 0 0 0 0 0 0 0 0 0 0 3 1 
1 3 0 0 0 0 0 0 0 0 0 0 0 0 0 0 0 0 3 1 
1 3 3 3 3 3 3 3 3 3 3 3 3 3 3 3 3 3 3 1 
1 1 1 1 1 1 1 1 1 1 1 1 1 1 1 1 1 1 1 1 
0 10 6 10